essay 	essays 	
precise 	precisely 	
restore 	restored 	
emerge 	emerged 	emerges 	
respond 	responded 	
properties 	property 	
enjoy 	enjoyed 	enjoying 	enjoys 	
hudson's 	hudson 	
render 	rendered 	rendering 	
supply 	supplying 	
please 	pleased 	pleasing 	
repair 	repaired 	repairs 	
departed 	departing 	
processed 	processes 	
walked 	walker 	
prohibited 	prohibition 	
excellence 	excellent 	
emotion 	emotional 	emotions 	
purchase 	purchased 	purchases 	purchasing 	
relative 	relatively 	relatives 	
detection 	detective 	
program 	programing 	programs 	
origin 	original 	
composed 	composer 	composers 	
comfortable 	comfortably 	
foundation's 	foundation 	foundations 	
australia 	australian 	
superior 	superiority 	
institute 	instituted 	institution 	
patrol 	patrolman 	
eight 	eighty 	
march 	marched 	marches 	marching 	
missing 	mission 	missions 	
qualified 	qualify 	
presidency 	president 	
impression 	impressions 	impressive 	
mature 	maturity 	
nearer 	nearest 	
independence 	independent 	independently 	
reflecting 	reflection 	
deduct 	deduction 	
tough 	tougher 	
canvas 	canvases 	
composite 	composition 	
photograph 	photographic 	photographs 	
ethical 	ethics 	
modes 	modest 	
reaction 	reactionary 	reactions 	
natural 	nature 	
exhibit 	exhibited 	exhibition 	exhibits 	
locate 	located 	locating 	location 	
collecting 	collection 	collections 	collective 	
personal 	personality 	personally 	
faith 	faithful 	
restrict 	restricted 	restriction 	
administration 	administrator 	
stress 	stressed 	stresses 	
informal 	informed 	
protect 	protected 	protection 	protective 	
sample 	samples 	sampling 	
author 	authority 	authors 	
youth 	youthful 	youths 	
dance 	danced 	dancer 	dancers 	dances 	
travel 	traveled 	traveler 	travelers 	traveling 	
report 	reported 	reporter 	reporters 	reporting 	reports 	
marty 	martyr 	
barnes 	barney 	
removal 	remove 	removed 	removing 	
performed 	performers 	
catholic 	catholicism 	catholics 	
color 	colored 	colorful 	colors 	
respect 	respected 	respective 	respects 	
approval 	approve 	approved 	
graduate 	graduated 	graduates 	graduation 	
tremble 	trembling 	
homer 	homeric 	
command 	commanded 	commander 	commanding 	commands 	
national 	nationalism 	nationally 	
engine 	engineer 	engineers 	engines 	
write 	writer 	writers 	writes 	
bridge 	bridges 	bridget 	
length 	lengths 	lengthy 	
ratio 	ration 	ratios 	
impressed 	impression 	impressive 	
great 	greater 	greatly 	
remind 	reminded 	reminder 	reminds 	
controlled 	controller 	controlling 	
government's 	government 	governmental 	governments 	
foreign 	foreigners 	
chart 	charter 	charts 	
build 	builder 	builders 	building 	
instructed 	instruction 	instructor 	
employed 	employer 	employers 	employes 	
comment 	commentary 	commented 	comments 	
adopt 	adopted 	adopting 	adoption 	
southern 	southerner 	southerners 	
aerated 	aerator 	
found 	founded 	founder 	founding 	
preventing 	prevention 	preventive 	
america's 	america 	american 	
indicate 	indicated 	indicates 	indicating 	indication 	indicator 	indicators 	
battered 	battery 	
follow 	followed 	followers 	following 	follows 	
parliament 	parliamentary 	
advise 	advised 	advisers 	
order 	ordered 	ordering 	orderly 	orders 	
restrain 	restrained 	restraint 	
manufacture 	manufactured 	manufacturer 	manufacturers 	
produce 	produced 	producer 	producers 	produces 	producing 	
manufacture 	manufactured 	manufacturer 	manufacturers 	manufacturing 	
complete 	completed 	completely 	
suggest 	suggested 	suggesting 	suggestion 	suggestive 	suggests 	
inquired 	inquiries 	inquiry 	
journal 	journalism 	
branch 	
drive 	driven 	driver 	drivers 	
direct 	directed 	direction 	directly 	director 	directors 	
delight 	delighted 	delightful 	
stick 	sticking 	sticks 	sticky 	
perfect 	perfection 	perfectly 	
visit 	visited 	visiting 	visitor 	visitors 	visits 	
success 	successes 	successful 	succession 	successive 	successor 	
electric 	electrical 	electricity 	
church's 	church 	churches 	
supplied 	supplies 	supply 	
generated 	generation 	generator 	generators 